7 3 6 6 6 8 7 7 8 2 4 8 9 7 0 6 6 6 6 6 6 6 6 6 6 6 6 6 6 6 6 6 6 6 6 6 6 6 6 6 6 6 6 6 6 6 6 6 6 6 
7 0 6 6 6 8 7 9 1 7 0 1 8 9 8 6 6 6 6 6 6 6 6 6 6 6 6 6 6 6 6 6 6 6 6 6 6 6 6 6 6 6 6 6 6 6 6 6 6 6 
9 7 6 6 6 3 9 9 3 8 7 9 9 7 8 6 6 6 7 8 9 0 4 7 8 9 9 8 7 3 2 8 0 3 9 9 7 8 8 9 7 0 4 9 6 6 7 8 1 0 
8 9 6 6 6 0 4 8 7 0 7 3 8 0 4 6 6 6 7 8 1 7 9 7 4 7 8 9 1 7 8 9 4 8 8 7 0 7 7 7 8 9 7 0 6 6 8 2 9 7 
8 8 6 6 6 6 6 6 6 6 6 6 6 6 6 6 6 6 9 7 3 4 8 0 9 8 7 9 4 1 2 7 9 8 9 7 4 1 3 8 9 9 7 3 6 6 4 7 7 9 
7 0 6 6 6 6 6 6 6 6 6 6 6 6 6 6 6 6 6 6 6 6 6 6 6 6 6 8 9 3 6 6 6 6 6 1 2 9 8 9 6 6 6 6 6 6 0 9 3 1 
9 9 6 6 6 6 6 6 6 6 6 6 6 6 6 6 6 6 6 6 6 6 6 6 6 6 6 7 8 9 6 6 6 6 6 8 8 9 9 4 6 6 6 6 6 6 8 9 7 4 
8 8 7 9 0 8 9 7 4 6 6 6 7 8 9 6 6 6 0 2 7 1 8 9 7 6 6 7 7 1 6 6 9 0 2 7 7 1 9 9 0 7 1 4 6 6 1 3 2 7 
8 7 9 1 8 2 9 8 8 6 6 6 8 9 7 6 6 6 7 3 9 2 7 1 4 6 6 6 6 6 6 6 2 3 2 3 4 7 7 7 3 9 4 7 6 6 7 8 0 9 
8 8 3 9 7 8 9 7 0 6 6 6 1 3 0 6 6 6 4 1 8 9 8 2 8 6 6 6 6 6 6 6 4 8 9 9 6 6 6 6 6 8 7 8 6 6 6 6 6 6 
7 9 0 1 4 9 3 1 6 6 6 6 9 7 8 6 6 6 7 7 2 1 2 4 8 8 7 9 9 3 7 0 8 9 8 7 6 6 6 6 6 8 3 9 6 6 6 6 6 6 
6 6 6 6 6 6 6 6 6 6 6 0 4 2 9 6 6 6 9 7 8 2 2 7 8 1 9 8 9 9 8 8 7 8 4 8 6 6 6 6 6 9 7 8 0 9 9 6 6 6 
6 6 6 6 6 6 6 6 6 6 8 9 7 1 4 6 6 6 9 7 2 7 3 1 9 7 4 3 7 0 3 8 9 3 7 8 6 6 6 9 3 9 8 1 9 8 0 6 6 6 
6 6 6 6 6 6 6 6 6 4 8 3 2 2 7 6 6 6 3 2 8 7 0 6 6 6 6 6 6 6 6 6 7 9 8 0 6 6 6 0 9 4 7 7 2 7 9 6 6 6 
6 6 6 8 9 4 9 0 9 7 2 9 2 7 0 6 6 6 2 1 8 9 2 6 6 6 6 6 6 6 6 6 9 7 8 7 6 6 6 9 8 6 6 6 8 3 9 6 6 6 
6 6 6 7 8 7 3 8 7 9 8 8 8 4 9 6 6 6 7 9 3 2 8 6 6 6 6 6 6 6 6 6 0 2 7 9 6 6 6 9 9 6 6 6 1 8 7 6 6 6 
6 6 6 9 3 7 9 2 4 8 3 9 7 8 1 6 6 6 0 2 7 7 0 6 6 6 6 6 6 6 6 6 9 8 4 9 6 6 6 8 7 4 6 6 7 9 0 6 6 6 
6 6 6 6 6 6 1 9 2 7 8 4 7 7 7 6 6 6 8 3 8 9 2 6 6 6 6 6 6 6 6 6 8 7 9 8 6 6 6 0 8 0 6 6 7 7 8 6 6 6 
6 6 6 6 6 6 7 8 7 1 3 7 2 8 0 6 6 6 1 7 8 4 8 6 6 6 6 6 6 6 6 6 7 3 2 0 6 6 6 9 7 9 6 6 0 9 8 6 6 6 
6 6 6 6 6 6 7 2 4 6 6 6 6 6 6 6 6 6 9 7 1 2 0 6 6 6 6 6 6 6 6 6 7 4 9 2 6 6 6 4 3 0 6 6 7 4 3 6 6 6 
7 1 9 2 0 7 4 9 9 6 6 6 6 6 6 6 6 6 2 8 8 9 8 7 9 8 6 6 6 4 9 8 7 9 1 9 6 6 6 6 6 6 6 6 6 6 6 6 6 6 
4 9 3 7 9 1 8 7 8 6 6 6 6 6 6 6 6 6 0 4 7 2 1 7 4 9 6 6 6 9 7 0 8 2 8 9 6 6 6 6 6 6 6 6 6 6 6 6 6 6 
0 7 2 8 8 2 7 3 0 6 6 6 9 0 8 6 6 6 9 8 9 7 2 2 8 0 6 6 6 2 7 8 8 3 2 8 6 6 6 6 6 6 6 6 6 6 6 6 6 6 
6 6 6 7 1 9 4 8 7 6 6 6 7 2 3 6 6 6 3 7 3 8 9 9 2 7 6 6 6 9 1 7 9 0 7 4 6 6 6 8 7 0 3 1 8 4 8 6 6 6 
6 6 6 4 3 8 9 9 7 6 6 6 8 9 7 6 6 6 0 8 2 9 7 9 4 9 6 6 6 2 2 9 8 2 9 7 6 6 6 7 8 2 9 8 7 1 9 6 6 6 
6 6 6 6 6 6 6 6 6 6 6 6 3 4 8 6 6 6 4 3 9 1 9 8 7 7 6 6 6 0 7 1 3 9 8 3 6 6 6 2 9 1 7 9 7 2 7 6 6 6 
6 6 6 6 6 6 6 6 6 6 6 6 7 9 7 6 6 6 8 7 8 8 0 1 8 3 6 6 6 8 2 9 8 7 8 0 6 6 6 3 4 9 8 4 9 8 0 6 6 6 
6 6 6 6 6 6 6 6 6 6 6 6 9 9 8 6 6 6 9 7 9 2 6 6 6 6 6 6 6 9 3 8 9 6 6 6 6 6 6 6 6 6 6 6 6 6 6 6 6 6 
7 3 0 3 9 9 8 4 7 1 8 8 4 0 1 6 6 6 9 8 8 4 6 6 6 6 6 6 6 8 7 9 2 6 6 6 6 6 6 6 6 6 6 6 6 6 6 6 6 6 
1 4 8 7 9 8 7 7 9 2 3 7 2 3 7 6 6 6 7 8 7 1 6 6 7 7 6 6 6 7 1 0 7 6 6 6 6 6 6 6 6 6 6 6 6 6 6 6 6 6 
0 4 9 8 1 7 3 2 8 9 6 6 1 7 7 6 6 6 3 9 8 8 6 6 2 2 6 6 6 8 9 3 1 6 6 6 9 7 9 4 7 9 8 2 1 7 6 6 7 7 
7 8 9 7 9 6 6 6 6 6 6 6 3 9 4 6 6 6 2 1 7 8 6 6 1 2 6 6 6 7 9 7 9 6 6 6 9 7 2 1 8 8 7 4 9 9 6 6 8 7 
8 7 9 9 4 6 6 6 6 6 6 6 9 8 2 6 6 6 4 2 1 9 6 6 2 2 6 6 6 4 8 8 1 6 6 6 7 0 9 7 2 9 1 6 6 6 6 6 0 4 
8 4 0 7 8 6 6 7 0 4 7 2 3 1 9 6 6 6 7 8 2 6 6 6 2 7 6 6 6 0 7 9 3 6 6 6 3 7 1 9 8 7 0 6 6 6 6 6 7 9 
6 6 6 6 6 6 6 6 6 6 6 6 6 6 6 6 6 6 9 3 0 6 6 6 2 1 6 6 6 6 6 6 6 6 6 6 6 6 6 6 6 4 7 8 2 7 7 3 9 9 
6 6 6 6 6 6 6 6 6 6 6 6 6 6 6 6 6 6 4 7 9 8 9 3 0 8 6 6 6 6 6 6 6 6 6 6 6 6 6 6 6 2 8 1 9 0 9 1 7 0 
6 6 6 6 6 6 6 6 6 6 6 6 6 6 6 6 6 6 0 9 3 7 9 9 7 4 6 6 6 6 6 6 6 6 6 6 6 6 6 6 6 0 7 9 6 6 6 6 6 6 
6 6 6 8 0 7 4 7 9 3 9 8 7 7 0 8 2 4 7 1 2 0 4 7 8 0 6 6 6 9 0 8 9 3 0 7 2 4 6 6 6 2 1 4 6 6 6 6 6 6 
6 6 6 7 9 8 3 8 7 8 0 3 9 4 9 7 3 9 8 4 7 6 6 6 6 6 6 6 6 3 9 2 9 7 4 9 0 7 6 6 6 7 8 8 6 6 6 6 6 6 
6 6 6 0 4 8 1 9 8 7 9 4 3 7 1 2 9 8 9 7 7 6 6 6 6 6 6 6 6 9 8 7 3 4 7 8 9 2 6 6 6 8 7 9 3 7 7 6 6 6 
6 6 6 2 8 8 9 6 6 6 6 6 6 6 0 7 8 0 7 8 3 6 6 6 6 6 6 6 6 4 2 8 7 9 1 9 8 9 6 6 6 3 0 1 9 2 8 6 6 6 
6 6 6 3 1 9 0 6 6 6 6 6 6 6 9 8 8 2 1 9 9 6 6 6 0 4 7 8 9 7 0 9 7 8 7 4 7 8 6 6 6 7 8 9 4 2 3 6 6 6 
6 6 6 9 9 2 7 6 6 6 6 6 6 6 7 8 4 9 7 8 0 6 6 6 9 1 9 7 0 1 8 9 8 8 0 9 1 9 6 6 6 9 8 3 9 1 0 6 6 6 
6 6 6 3 7 8 7 6 6 6 6 6 6 6 2 4 8 0 1 3 7 6 6 6 3 8 2 6 6 6 6 6 6 6 6 7 9 0 6 6 6 9 7 2 7 8 9 6 6 6 
6 6 6 0 8 8 7 0 9 6 6 6 7 9 9 1 7 9 7 4 9 6 6 6 7 9 8 6 6 6 6 6 6 6 6 1 9 3 6 6 6 4 1 8 9 7 1 6 6 6 
6 6 6 8 8 9 4 7 3 6 6 6 4 9 8 2 8 9 8 9 8 6 6 6 8 9 7 7 7 4 9 0 7 6 6 8 4 9 6 6 6 7 9 3 1 8 2 6 6 6 
6 6 6 7 9 8 9 3 7 6 6 6 9 3 7 7 0 9 3 8 9 6 6 6 7 0 2 1 7 8 1 7 3 6 6 9 8 7 6 6 6 9 9 8 8 4 7 6 6 6 
6 6 6 6 6 6 6 6 6 6 6 6 6 6 6 6 6 6 6 6 6 6 6 6 6 6 6 6 6 6 6 6 6 6 6 6 6 6 6 6 6 6 6 6 6 6 6 6 6 6 
6 6 6 6 6 6 6 6 6 6 6 6 6 6 6 6 6 6 6 6 6 6 6 6 6 6 6 6 6 6 6 6 6 6 6 6 6 6 6 6 6 6 6 6 6 6 6 6 6 6 
6 6 6 6 6 6 6 6 6 6 6 6 6 6 6 6 6 6 6 6 6 6 6 6 6 6 6 6 6 6 6 6 6 6 6 6 6 6 6 6 6 6 6 6 6 6 6 6 6 6 
